0000000000000000
0000100000000000
0000000000000000
0110000000000000
0000010000000000
0001100000000000
0000000000000000
0000011001100000
2022210000100000
0000212020100000
0000010022122200
0000010000100202
0000011011100000
0000000000000000
0000000000011000
0000000000100000
0000000000000110
0000000000000000
0000000000010000
0000000000000000