000011011101111
101110000001001
000100110010000
100000001001000
001001010001100
000100001000000
101100101100110
100100100100010
000101110000011
010000101011111