0000000000000000
0000100000000000
0000000000000000
0110000000000000
0000010000000000
0001100000000000
0000000000000000
0000011001100000
1011110000100000
0000111010100000
0000010011111100
1000010000100101
1000011011100000
1000000000000000
1000000000011000
0000000000100000
0000000000000110
0000000000000000
0000000000010000
0000000000000000