000022222222000444444022330000000000
000022222222000444444022233300000000
220222222000000044440002233330011100
222222222000000044040002230033011100
222222222000000000000032220000011100
222220000000000000300033000000000000
220000040000000000000000220000010100
200000004400000000000032230000000000
000000000000000000000032330000000300
000000000000000003300032333000000000
000000000000000000000330003000000000
000033000000000000220022330000230002
003333000040001000222020333000200332
330000000000000000222220330003220222
333300003000300000022220033000320200
333000000310030000022200330000000000
333303000000000003000003333000000000
333000000000003000000000000000000404
333300300000303000000000000000300040
333300000000000030000130000003330040
300000000000000003030300330033333400
000001000000000030000330003333333300
000000000000000003303000030030043000
222000000000000333000000033033000000
002220000000000333330330330000403000
000022000000300003300000033443034000
000002000000000033000000330404440000
000002200000000003000103033030033000
000000202200030000000000000004400444
000000000222000000000000300440040000
031111000032000000000000203000000000
001111000302200000000022200000000010
001111000330200000220022200022000000
000000000000220000222222200022220000
000000000000000022222222000022220000
000000000003020022222222002222200003
